Barcode	annotation
AAACCCGAACGAAATC.1	Mid
AAACGAGACGGTTGAT.1	Central
AAAGTGTGATTTATCT.1	Mid
AAAGTTGACTCCCGTA.1	Central
AAATAAGGTAGTGCCC.1	Central
AAATACCTATAAGCAT.1	Central
AAATAGCTTAGACTTT.1	Mid
AAATTAACGGGTAGCT.1	Central
AAATTCCAGGTCCAAA.1	Central
AACACACGCTCGCCGC.1	Mid
AACCCTACTGTCAATA.1	Mid
AACCGCTAAGGGATGC.1	Periportal
AACCTCGCTTTAGCCC.1	Periportal
AACCTGTCACGGAATT.1	Central
AACGGACGTACGTATA.1	Mid
AACGTGCGAAAGTCTC.1	Central
AACTACCCGTTTGTCA.1	Mid
AACTCTCAATAGAGCG.1	Central
AAGACTGCAAGCTACT.1	Central
AAGAGCTCTTTATCGG.1	Central
AAGAGGCATGGATCGC.1	Central
AAGCCGAAGCGGTTTA.1	Central
AAGCTAGATCGAGTAA.1	Mid
AAGCTCGTGCCAAGTC.1	Central
AAGCTCTTTCATGGTG.1	Periportal
AAGGATCGATCGCTTG.1	Mid
AAGGTGATAAACCAGC.1	Mid
AAGTCAATTGTCGTCA.1	Mid
AATAGAATCTGTTTCA.1	Central
AATAGTCCGTCCCGAC.1	Periportal
AATCGCCTCAGCGCCA.1	Central
AATCGCGCAGAGGACT.1	Mid
AATCTGCGTTGGGACG.1	Central
AATGACGTAGGATGTC.1	Mid
AATGCAACCGGGTACC.1	Mid
AATTAACGGATTTCCA.1	Periportal
AATTGAACGCTCTGGT.1	Central
ACAAATGGTAGTGTTT.1	Central
ACAACAGCATGAGCTA.1	Central
ACAAGGAAATCCGCCC.1	Mid
ACAAGGGCAGGCTCTG.1	Mid
ACAATTGTGTCTCTTT.1	Mid
ACACACCAGGACCAGT.1	Mid
ACACCACATAATTAGC.1	Central
ACACCTTACTACTTGC.1	Central
ACACGAGACTCCTTCT.1	Central
ACATCGATCGTTTACC.1	Central
ACATCGTATGCAATGG.1	Central
ACCACAAGTTTCTATC.1	Central
ACCACGTGCAGCTATA.1	Mid
ACCAGTGCGGGAGACG.1	Mid
ACCCAACGCCCGTGGC.1	Portal
ACCCTCCCTTGCTATT.1	Central
ACCGACTGAGTCCCAC.1	Central
ACCGATGGTAGCATCG.1	Central
ACCGGGCCTTTGTTGA.1	Periportal
ACCTACAGTATGTGGT.1	Mid
ACCTCCGTTATTCACC.1	Portal
ACGATCATCTTGTAAA.1	Mid
ACGCATTCGTGAGTAC.1	Central
ACGCCGCTAGACGACC.1	Mid
ACGCGGGCCAAGGACA.1	Mid
ACGGACTCTCAAAGCG.1	Periportal
ACGGATGGTGCGGATA.1	Periportal
ACGGCGACGATGGGAA.1	Mid
ACGTAGATTGCTGATG.1	Mid
ACGTATTACTCCGATC.1	Mid
ACGTTAATGTCGAAGA.1	Central
ACGTTCGCAATCAATT.1	Central
ACTATCCAGGGCATGG.1	Mid
ACTCCCGAATTCGTTT.1	Periportal
ACTCCCTAATGCTAAA.1	Periportal
ACTCCCTAGAATAGTA.1	Mid
ACTCGTCAGTAATCCC.1	Central
ACTCTCTGACTTAGGT.1	Central
ACTCTTGTATAGTAAC.1	Central
ACTGAATGGCGAAAGT.1	Central
ACTGTCCAGGATTATA.1	Mid
ACTGTCTTCTTTAGAA.1	Central
ACTTATACTTACCCGG.1	Central
ACTTATTTATGTGCCA.1	Mid
ACTTCCATGCGGGACA.1	Periportal
ACTTGACTCCCTCTTT.1	Mid
ACTTTACCCTCATGAA.1	Portal
ACTTTCCTATAGCTTC.1	Central
AGAATTATGGATTCGA.1	Mid
AGACCCGCCCTCCTCG.1	Central
AGACGAAGTGCCGGTC.1	Mid
AGATACTCAAGATCGA.1	Central
AGATATAATACGACTA.1	Periportal
AGATCTCAGGTGTGAT.1	Central
AGATGATGGAGTCTGG.1	Portal
AGCAACATATCTTATT.1	Central
AGCACCAGTACTCACG.1	Central
AGCATATCAATATGCT.1	Mid
AGCGACCAACGATATT.1	Mid
AGCGTGGTATTCTACT.1	Mid
AGCTCCTTCGCACATC.1	Central
AGCTCTAGACGTTCCA.1	Central
AGGACAGTCGAATCCC.1	Central
AGGATATAGGGATTTA.1	Portal
AGGATTGCTTACGACA.1	Central
AGGCATTGTCGTAGGG.1	Mid
AGGCCTGAGAATCTCG.1	Mid
AGGGACCGGCTGCGTT.1	Portal
AGGGCTGCAGTTACAG.1	Mid
AGGGTCGATGCGAACT.1	Mid
AGGGTGCTCTCGAGGG.1	Central
AGGGTTCCCTTTGGTT.1	Mid
AGGGTTTAGTTCGGGA.1	Mid
AGGTATAATTGATAGT.1	Periportal
AGGTTACACCATGCCG.1	Mid
AGGTTTCACACACCTT.1	Mid
AGTCAAGATGACACTT.1	Mid
AGTCGACGGTCTCAAG.1	Central
AGTCGGTTGCGTGAGA.1	Mid
AGTGAGACTTCCAGTA.1	Periportal
AGTGATAACCTGCGCG.1	Periportal
AGTGATTCAAGCAGGA.1	Central
AGTGCTAAACACAGCA.1	Periportal
AGTGCTTGCACGAATA.1	Central
AGTTCCTATTTATGTT.1	Central
AGTTTGCACCTGCCTC.1	Periportal
AGTTTGGCACGGGTTG.1	Mid
ATAAACGGACCCGTAA.1	Central
ATAACGCCGGAGGGTC.1	Central
ATAAGGTGGAGAACAT.1	Periportal
ATAAGTAGGGCGACTC.1	Periportal
ATAATAGCTGTTGAAT.1	Central
ATAATCTTGGAGAACC.1	Mid
ATACAGGCCCTCCAAT.1	Periportal
ATACGCCGGCGAAACC.1	Central
ATACGTCCACTCCTGT.1	Mid
ATAGGTTGGGCAGATG.1	Central
ATATAAAGCGCTCGTG.1	Periportal
ATATCAACCTACAGAG.1	Mid
ATATCGGTAGGGAGAT.1	Portal
ATATCTTAGGGCCTTC.1	Mid
ATATGTCTCCCTAGCC.1	Central
ATATTCCACATAGTGA.1	Periportal
ATATTTAACCCTCAAG.1	Central
ATCAAACACTGTTCCA.1	Mid
ATCAATCTGGGCTGCA.1	Mid
ATCATCCAATATTTGT.1	Central
ATCCACATCGACAGAA.1	Periportal
ATCGACCCAATACAGA.1	Central
ATCGCACGCCGGGAGA.1	Mid
ATCGCCAGTCAACATT.1	Mid
ATCTTGACTTGTCCAA.1	Periportal
ATGACTATGCGACATT.1	Central
ATGCCATTTGCGACCA.1	Mid
ATGCCGGTCTTGCATA.1	Mid
ATGCGACAGTCCCATT.1	Central
ATGCTCTGGCGCGGTA.1	Periportal
ATGGAGCAGGCCGTGA.1	Mid
ATGGATTGACCAAACG.1	Central
ATGGCGGAATAGTCGC.1	Central
ATGGGCCTCGGCCTCT.1	Periportal
ATGGTCGCGTGGTTTC.1	Central
ATGTAAGGCTGCTCTT.1	Mid
ATGTGGACATCTTGAT.1	Mid
ATTAAACATGCGGACC.1	Central
ATTAGGCGATGCTTTC.1	Central
ATTATAGCTACTTTAC.1	Central
ATTCATATACTGTCCA.1	Mid
ATTCATCGTTGAGGCA.1	Periportal
ATTCGTGCTATCTCTT.1	Central
ATTGATGAGTCCTAAC.1	Mid
ATTGTACAACTCGGCT.1	Mid
ATTTACTAAGTCCATT.1	Mid
ATTTGTCTTGGGAGCT.1	Central
CAACACATCTCCTGCC.1	Central
CAAGAGGGCGGAGTAC.1	Mid
CAAGATATTATAACGT.1	Mid
CAAGGATCGCATGTTC.1	Central
CAAGGTCCTATAGGCT.1	Portal
CAAGTGTGGTTGCAAA.1	Central
CAATGTGCCAACCCTT.1	Mid
CAATTAAGGGTGATGA.1	Central
CAATTTCGTATAAGGG.1	Mid
CACACGCGCTGTCTTA.1	Central
CACAGCACCCACGGCA.1	Central
CACATATTAGCAGGAT.1	Mid
CACATCTCACCGACGA.1	Periportal
CACATGATTCAGCAAC.1	Central
CACCCAAATCTTATGT.1	Periportal
CACCCTAACAAGATCT.1	Periportal
CACCGCCAGAAGGTTT.1	Central
CACGCGGAACTGTTGC.1	Central
CACGTTCGTGCTCTAG.1	Central
CACTCAAGAGCTATGG.1	Mid
CACTCGAGCTGAACAA.1	Mid
CAGACCTGTAAGTGTT.1	Mid
CAGCTCACTGAGACAT.1	Central
CAGGCGCCATGCTAGG.1	Periportal
CAGTCTGTATACTGGG.1	Mid
CATAACGGACAGTCGT.1	Central
CATACGGCGTCTGGGC.1	Central
CATACTTAGGCAATAC.1	Portal
CATCGGACGGGTTAAT.1	Central
CATCTTACACCACCTC.1	Mid
CATGATGGAAGTTAGC.1	Mid
CATGGGTATGCCTTAT.1	Periportal
CATGGTAAGTAGCGTT.1	Mid
CATGTCTCATTTATGG.1	Central
CATTCCCATTCCGTCG.1	Central
CCAAGCGTAACTCGTA.1	Central
CCACAGTACCCATCCT.1	Mid
CCACCCAAGGAAAGTG.1	Central
CCACGGTGCCCGGTAG.1	Periportal
CCAGCCTGGACCAATA.1	Mid
CCAGCGGGATCACCAG.1	Mid
CCAGGGACGTGGCCTC.1	Central
CCATACCTTTACTTGT.1	Mid
CCATCTCACCAGTGAA.1	Mid
CCATGCCTGTTTAGTA.1	Central
CCCAAACATGCTGCTC.1	Central
CCCAGGTCTGAAGGCT.1	Mid
CCCAGTTAAGGCGCCG.1	Central
CCGAACCTTCCCGGCC.1	Mid
CCGAGAAGTCGCATAA.1	Mid
CCGATCTCAACCTTAT.1	Mid
CCGCACAAAGACCAAC.1	Central
CCGGCACGACCGTTTC.1	Portal
CCGGGCGGTCTCGTCA.1	Central
CCGGGCTGCTCCATAC.1	Mid
CCGGTAATGGCTAGTC.1	Portal
CCGTAAGTTGGTCCCA.1	Central
CCTAAATTAACGGTTC.1	Mid
CCTAACCCAAACAAGT.1	Central
CCTAGGCGTAGCGATC.1	Central
CCTATGAAGTGGTGCC.1	Portal
CCTATGGGTTACCGTC.1	Central
CCTATGTCCACTCCAC.1	Periportal
CCTCGGACCGGGATAG.1	Central
CCTGGAAACGTTCTGC.1	Portal
CCTGGTCGAATGTGGG.1	Periportal
CCTGTAAGACATGATA.1	Periportal
CCTGTCACCCGGGCTC.1	Mid
CCTGTCCCTCACGTTA.1	Portal
CCTGTCGCCCGTAAAT.1	Periportal
CCTTGACCACTTTATT.1	Central
CGAACAGTATGGGCGT.1	Mid
CGACAATTTGATCTAA.1	Mid
CGACACGCTCCGACAG.1	Periportal
CGACTTTGTATAGCCT.1	Periportal
CGAGACCCTAGAGTGT.1	Mid
CGAGAGATGTGAACCT.1	Central
CGAGATTTCGCTCGGG.1	Mid
CGAGGCTAAATATGGC.1	Periportal
CGAGGGACTGCGGTCG.1	Central
CGATTCGCCTGGCTGC.1	Periportal
CGCACATGTCCACTAC.1	Central
CGCATGGTGCGATGCT.1	Central
CGCATTAGCTAATAGG.1	Central
CGCCGCCCATGCCTGT.1	Central
CGCCTCCCTCCTCTAT.1	Mid
CGCGGCTCAACTTGAA.1	Central
CGCGGTAAGTCTAGCT.1	Mid
CGCTATTCTTAGGCTC.1	Mid
CGCTGGTGACTACCCT.1	Mid
CGCTTTCTTGCATTCG.1	Portal
CGGAGCATGGCGATCC.1	Central
CGGCAGGGTCGGGTTG.1	Mid
CGGCCACGCACAAAGT.1	Mid
CGGCTCTAAAGCTGCA.1	Mid
CGGGAATATAGTATAC.1	Mid
CGGGAGCTTCAGTGTA.1	Mid
CGGGCAGCTAAACCGC.1	Central
CGGGTGTACCCATTTA.1	Mid
CGGTACTAGAATCAAA.1	Central
CGGTTATCCAACAGTG.1	Central
CGTATTAAGAGATCTA.1	Mid
CGTCGGATAGTGTTGA.1	Central
CGTGCAGACTGGGACA.1	Mid
CGTGCCCTCCCGAAGA.1	Mid
CGTGGCCGAATATCTA.1	Mid
CGTGTGTTAAACCCTG.1	Central
CGTTAATGTCCCGACG.1	Periportal
CGTTGAATACCGCGCT.1	Periportal
CGTTGAGCGACCGTCG.1	Mid
CTAACGAAACTTGCTG.1	Mid
CTAAGGGAATGATTGG.1	Mid
CTACCCTAAGGTCATA.1	Central
CTACTGCCACCTGACC.1	Central
CTAGATGTGAGTGTAA.1	Mid
CTAGATTTACGACGGC.1	Mid
CTAGCATAGTATAATG.1	Mid
CTAGGTCTGAAGGAAT.1	Mid
CTAGGTTCGGACGTGA.1	Periportal
CTAGTAGAAAGGGATT.1	Mid
CTAGTCACGTCTTAAG.1	Central
CTATCGGGTCTCAACA.1	Central
CTATGTCACTAGCCCA.1	Central
CTATTTGGTTACGGAT.1	Central
CTCACTGTGATACTTA.1	Periportal
CTCGAGGTCGAACAGT.1	Central
CTCGGGATAACACCTA.1	Central
CTCGGTACCACTGCTC.1	Central
CTCTATTTGGCTGCAG.1	Mid
CTCTCACAATCGATGA.1	Central
CTCTGGACGCCTGGTG.1	Central
CTCTTCTATTGACTGG.1	Periportal
CTGACTGCGCAGCTCG.1	Mid
CTGCACAACTACATAT.1	Periportal
CTGCACCTAGTCCACA.1	Mid
CTGCCATGCATCACAT.1	Central
CTGCCTCATATGCAAC.1	Mid
CTGGAAATGGATGCTT.1	Central
CTGGAAGACACGGTGG.1	Central
CTGGCGCACAGGTCTG.1	Central
CTGGCTGATTCATCCT.1	Mid
CTGGGATAAATAATGG.1	Central
CTGGGATACGCTACCC.1	Mid
CTGGGTAGGCAGTTAA.1	Central
CTGGTAACACATAGAA.1	Central
CTGGTTTCGAGCAAGA.1	Mid
CTGTGCAGGGTAGGTC.1	Mid
CTTAGTAGGCCTACAG.1	Mid
CTTCATTGTCAGTGGA.1	Mid
CTTGAGTTAGGGTAAT.1	Mid
CTTGTTGCTGAGTCAA.1	Central
CTTTAGGAACACTGTT.1	Central
GAAACAGATGACCACC.1	Mid
GAAAGAACAGCGTTAT.1	Mid
GAAATGGCGGTGTTAG.1	Central
GAACAGATTACTAAAT.1	Periportal
GAACCCTCTGTGTTCT.1	Periportal
GAACGTCTCATGGTCG.1	Periportal
GAAGCGTGAGGAATTT.1	Mid
GAAGTCTCCCTAGCGA.1	Central
GAATAGACGCGACCCA.1	Central
GAATCTGAACATTCTC.1	Central
GAATGTGGTCCGGATT.1	Central
GAATTATAGTGAAAGG.1	Mid
GACAAACATATGCAGG.1	Mid
GACACAAGGGAAGAAA.1	Central
GACAGCCAGACCTGAC.1	Central
GACCGACGTGAAAGCA.1	Portal
GACGACGATCCGCGTT.1	Periportal
GACGGTCAATAGAAGC.1	Central
GACTCACCCACGTGAG.1	Mid
GACTGCACCAGCCCAG.1	Central
GAGACTGATGGGTAGA.1	Central
GAGATCTGTCACTCCG.1	Central
GAGATCTTCCATGACA.1	Mid
GAGCGCGCACGAGTAG.1	Mid
GAGGATAAACAGTGCT.1	Periportal
GAGTATGCGCGTGCAT.1	Portal
GAGTGTCAACCAGAAA.1	Mid
GAGTGTGCGGTACCCA.1	Mid
GATAACTCGCACTGTG.1	Central
GATATGAGACACTAAC.1	Central
GATATTGAGATTGGCG.1	Mid
GATCATTCCAAACATT.1	Central
GATCCCTTTATACTGC.1	Central
GATCCGGGAATTAACA.1	Central
GATCGGTGGCCATAAC.1	Central
GATCGTGACTGATATC.1	Central
GATCTTGGAGGGCATA.1	Mid
GATGCGTCCTGCATTC.1	Mid
GATGCTGTATTTCATC.1	Mid
GATTCGACGGTTCACG.1	Mid
GCAACAGCAGTATGCG.1	Mid
GCAACGGCTAGTTATG.1	Central
GCACAAACGAGGCGTG.1	Mid
GCAGATTAGGGATATC.1	Mid
GCAGCACACAGCCCAG.1	Periportal
GCAGCCTATATCACAT.1	Periportal
GCAGTGTGGCTATAGG.1	Periportal
GCATAGAGCACTCAGG.1	Mid
GCATGAGGGACGCGGC.1	Mid
GCATTTCCAAGGCTCC.1	Portal
GCCATCGATGCTGCAT.1	Periportal
GCCGATTGGCCAAGCT.1	Central
GCCGCTTGTGAGAAAC.1	Periportal
GCCGGGTTAGGGTCGC.1	Mid
GCCGTGGAAGAAATGT.1	Periportal
GCCTCATCTGGAAATA.1	Central
GCGAAACTTAACTGGA.1	Central
GCGAAGCCATACCCGT.1	Central
GCGACATGTAAACATC.1	Mid
GCGAGAGTTGCGTCCA.1	Portal
GCGAGCGCATGCTCCC.1	Portal
GCGAGTTCTGCAAAGA.1	Periportal
GCGATTGTTAACGTTA.1	Central
GCGCCGTTCCACGATA.1	Central
GCGCTAATTGAATAGA.1	Central
GCGGAGAGGGAGAACG.1	Mid
GCGGGCATTACGATGC.1	Central
GCGTAAATGGCCATAA.1	Mid
GCGTGGTACTGGGTTA.1	Central
GCTAAGTAGTTTCTCT.1	Mid
GCTACGACTTATTGGG.1	Mid
GCTACTATAGTAGAGT.1	Mid
GCTAGTAGAGCTTGTA.1	Central
GCTATACGTCTCGGAC.1	Central
GCTCCGCTCGCTTCAG.1	Central
GCTCTCGGGTACCGAA.1	Mid
GCTGAGGCGTGAGTAT.1	Central
GCTGCACGGTTTCTTA.1	Central
GCTGCTCTCCGGACAC.1	Central
GCTGTTGCTACCGAAC.1	Mid
GCTTAATGTAACTAAC.1	Central
GCTTACGTAGTTAGTA.1	Portal
GCTTATGAAGCAGGAA.1	Central
GCTTGGATCGATTAGG.1	Mid
GCTTTCAGAGGAGGTG.1	Central
GGAATGCGCTAGCGTG.1	Mid
GGACACAAGTTTACAC.1	Mid
GGAGACGACACCTTTG.1	Mid
GGAGGCCGAAGTCGTC.1	Periportal
GGAGGGCTTGGTTGGC.1	Central
GGATCCGGAATATACT.1	Mid
GGATGAAGATCGCTGA.1	Central
GGATGTCCTTACCGCA.1	Central
GGATTTCACTTCTATA.1	Mid
GGCAATAGTCAATGAG.1	Central
GGCCCGGAGCATGTCT.1	Central
GGCGAAATCTAACTTG.1	Central
GGCGCGGAGATCTTTC.1	Periportal
GGCGGTAGGATCATTG.1	Central
GGCTCGCGTTGAGGTA.1	Central
GGCTGAAATAGCAAAG.1	Mid
GGGACTGCATAGATAG.1	Central
GGGAGAACTCACAGTA.1	Mid
GGGAGTTAATGAGGCG.1	Central
GGGATTTACCGCACCT.1	Mid
GGGCCGGCCGAAGTAC.1	Central
GGGCGATATGTGTGAA.1	Central
GGGCGCAGCGTTACTC.1	Central
GGGCGGGTTCCCTACG.1	Periportal
GGGCTGCCTAGGGCGA.1	Mid
GGGTGCATATGAAAGC.1	Central
GGGTTTAGGATAGGAT.1	Central
GGTAGTGCTCGCACCA.1	Central
GGTATAGTGACACATA.1	Mid
GGTCGGCCAGGAGCTT.1	Periportal
GGTCTGAGAATCTGGA.1	Central
GGTGATAAGGAGCAGT.1	Central
GGTTACCCGACACTTT.1	Central
GGTTAGCTATATGTCT.1	Central
GGTTTAGCCTTTCTTG.1	Periportal
GGTTTCAATCGGTCAG.1	Central
GTAACATCTAAGATAA.1	Central
GTAAGTAACAGTCTGG.1	Central
GTAATAAAGGGCTCCC.1	Mid
GTACACTTACCTGAAG.1	Mid
GTACGCTTCATTGCAC.1	Central
GTACTAAGATTTGGAG.1	Central
GTACTGGAGTTAGACC.1	Mid
GTAGCCAAACATGGGA.1	Periportal
GTAGCGGCTATACACT.1	Central
GTAGCTTCCTCTTGTT.1	Mid
GTAGTCGCGGGAATCA.1	Mid
GTATCTTTCATAACCA.1	Central
GTATGTGGGTCTAGTT.1	Mid
GTCAAGCGGACTCGGG.1	Central
GTCATGCACCTCCGTT.1	Central
GTCATGGACATGACTA.1	Central
GTCATTAGAGCGAACG.1	Central
GTCCCAACGTAAAGTA.1	Central
GTCCGGCTGAATTGCG.1	Central
GTCGCGTAACCCGTTG.1	Central
GTCGTACCATCTCGGG.1	Mid
GTCGTTATTCGCTTAT.1	Mid
GTCTATTGGTTCCGGT.1	Central
GTCTCAAGGCCCGGCT.1	Periportal
GTCTTGAGGAGCAGTG.1	Periportal
GTGAACTCCCATTCGA.1	Mid
GTGACCGCACACTACG.1	Mid
GTGACGAGGGTGACCC.1	Central
GTGAGGACACTTAAGG.1	Central
GTGATCACTAACGCCT.1	Mid
GTGATCCTTGTCATGA.1	Periportal
GTGCCCGTTCGGATTC.1	Central
GTGCGACAGGGAGTGT.1	Mid
GTGCGTGTATATGAGC.1	Central
GTGGTGGCCAAGTGAA.1	Mid
GTGGTTACTTCTTTCG.1	Periportal
GTGTATATCAGCGGGC.1	Periportal
GTGTGAATAACTTAGG.1	Mid
GTGTTACTATGCGTCC.1	Central
GTTAACTATGTTGTCA.1	Central
GTTAAGTTAGAGTGGG.1	Central
GTTACCTACAACTTGC.1	Central
GTTAGCCGTAAATCAA.1	Mid
GTTATAATACGGTGAA.1	Central
GTTCATCGTTTGGCTG.1	Portal
GTTCGGGCGTACCATT.1	Portal
GTTCGTCTAAAGAACT.1	Central
GTTGGATTGAGAACAC.1	Central
GTTTCTGCAGTCTCCC.1	Central
GTTTGACCAAATCCTA.1	Central
GTTTGGCCCAAGTTAT.1	Central
TAACATACAATGTGGG.1	Central
TAACCTACCGTCCGAG.1	Mid
TAAGGCTGAATCCCTC.1	Mid
TAATTAGGACATCCGT.1	Central
TACAGAAACGGTGGGC.1	Periportal
TACATAGGCATACACC.1	Central
TACCGCGGACTTGCAG.1	Mid
TACCGGCTCACTGCCC.1	Central
TACGCCATATTCTAAT.1	Mid
TACGCTATAGAAACCT.1	Periportal
TACTTGTTAGTAGTCC.1	Mid
TACTTTACTGAGCCGG.1	Central
TAGAAAGGTGGCGCTA.1	Central
TAGACGCCCGTACCGG.1	Central
TAGAGTCTAAGCGAAC.1	Central
TAGCCATTTCAAAGTC.1	Central
TAGCCGGCGGTCAGCG.1	Mid
TAGCGTTGGGTCTTAC.1	Central
TAGCTAAGTCCGGGAG.1	Central
TAGGTCGCCGGAACTG.1	Mid
TAGGTGACGATAACCT.1	Periportal
TAGGTGCTCGCCTAGC.1	Central
TAGGTTCGAGTTCGTC.1	Mid
TAGTCGATCACGGGTT.1	Mid
TAGTGCCCTCCAGAGT.1	Central
TATATCCCTGGGAGGA.1	Mid
TATCTACCACAGCGGG.1	Central
TATGGATGTGCTACGC.1	Central
TATGGGTACGTATCGT.1	Central
TATGGTCTGAGTAACA.1	Mid
TATTACCATCCTGCTT.1	Mid
TATTCAATTCTAATCC.1	Central
TATTCGTGCCAGAATA.1	Portal
TATTGACATTTCTGCC.1	Central
TCAAACTTAGATTGTT.1	Central
TCAAATTTGAGACTCA.1	Periportal
TCAAGAAATACTAGCT.1	Periportal
TCAAGGTTACTACACC.1	Periportal
TCACAGGGAATCGCAA.1	Mid
TCACCGCTCGGCACTC.1	Mid
TCACGTGCCCGATTCA.1	Central
TCAGACGCTATAGAAG.1	Mid
TCAGCAAATGCATCTC.1	Central
TCATTTAAGTCTCCGA.1	Mid
TCATTTAGAAGTGTGA.1	Central
TCCAGAGCACCGGTTC.1	Central
TCCAGGCGAGTACGGT.1	Central
TCCCAAAGACGAAGGA.1	Mid
TCCCAAAGCCCTAAAT.1	Mid
TCCCACTCTCTTCCGG.1	Portal
TCCCAGCTTTAGTCTG.1	Central
TCCCGCCTATGTGCGT.1	Mid
TCCCGTCGCGTCATAG.1	Central
TCCCGTGTGCAATTTG.1	Central
TCCGAATGGTCCTGAG.1	Central
TCCGCCTGTCTACAAG.1	Periportal
TCCGCGGCAGCATCTG.1	Central
TCCGCTGTCATCCCGG.1	Central
TCCTACATCCACGGCC.1	Mid
TCCTCGGGCTGGGCTT.1	Central
TCCTTACGACGGTCCG.1	Mid
TCCTTTCTTACGCTTA.1	Central
TCGAAGAACCGAGCAC.1	Mid
TCGCAAAGATGCATTT.1	Mid
TCGCACCAGGAGGCAG.1	Mid
TCGCTCGATATATTCC.1	Central
TCGGACGCCCAGCCCA.1	Mid
TCGGAGTACATGAGTA.1	Central
TCGGGAACGTGCCTAG.1	Periportal
TCGGGCCGTCGTGGTA.1	Central
TCTACCGTCCACAAGC.1	Central
TCTAGCATGCCCAGAA.1	Mid
TCTAGTGATATCGTGG.1	Mid
TCTAGTTATCAGAAGA.1	Central
TCTCATGAGATAGGGT.1	Central
TCTCCACAAGTTGAAT.1	Periportal
TCTCGACGTATCGCCG.1	Mid
TCTGAACTCGTACCCG.1	Periportal
TCTGAAGCACGTGGTC.1	Periportal
TCTGAATTCCGTACAA.1	Central
TCTGATCGGGTGCTAG.1	Central
TCTGCCAGAAACTGCA.1	Central
TCTGTGCCATCATAGT.1	Mid
TCTTACTTATGCCTCT.1	Mid
TCTTAGAGCTCCAATT.1	Central
TCTTCCCATGGGCACA.1	Mid
TCTTCGAATAGACGTT.1	Central
TCTTCGATACCAATAA.1	Mid
TCTTGATGCGTAGCGA.1	Central
TCTTTAAGACTATGAA.1	Mid
TCTTTAGCAGGCGAAC.1	Central
TGAAAGGACCTGACTC.1	Mid
TGAATGTCAGCCGGCC.1	Mid
TGACATCGAGCGGACC.1	Mid
TGACGATGCACTAGAA.1	Mid
TGAGAGATTTACCACG.1	Central
TGAGTGGTCCGTGACG.1	Periportal
TGATCGGTTTGACCCT.1	Central
TGCAACCCATCTGCGG.1	Periportal
TGCAAGAATGACGTAA.1	Central
TGCAATCTAACACGGT.1	Periportal
TGCAGTTTCCTCCCAT.1	Mid
TGCATATGTCTGTCAC.1	Central
TGCCCGTACCGTTAAA.1	Mid
TGCCGAAAGCGTATTC.1	Central
TGCGCAAAGCATTTGG.1	Central
TGCGTTTGTTGACACT.1	Central
TGCTAAGTGTCTATTT.1	Mid
TGCTCCACAGTTCTTA.1	Periportal
TGCTCTTGAGAGTTTG.1	Periportal
TGCTGTTGAAGAACTC.1	Central
TGGACCAATCTAAGAT.1	Periportal
TGGACTGTTCGCTCAA.1	Central
TGGCAAACTAAATTAC.1	Mid
TGGCAGATTACGATCA.1	Mid
TGGCAGCAGTAATAGT.1	Mid
TGGCTATGTGACATAC.1	Periportal
TGGGCCCATACTAATT.1	Mid
TGGTAGAATATATGGG.1	Mid
TGTACCTACACGAGGG.1	Periportal
TGTAGGAGAAATTTCC.1	Central
TGTATGGCGCAGACAG.1	Mid
TGTTATTGTATGTGGC.1	Central
TTAAACTCGAATTCAT.1	Mid
TTAATGTAGACCAGGT.1	Central
TTACGGATGGTTCGAG.1	Central
TTACTAAAGGACTTTA.1	Mid
TTACTCCGGCCGGGAA.1	Mid
TTAGACGAGTCACCTC.1	Mid
TTAGAGTTTAGAAGGA.1	Central
TTAGCTGATTTGCCGT.1	Mid
TTAGTTATTCGTGGCA.1	Mid
TTATATACGCTGTCAC.1	Central
TTATATTTGGCAATCC.1	Central
TTATCCGGGATCTATA.1	Central
TTATGAATGAAAGGGA.1	Central
TTATGATCTTAACGAA.1	Central
TTATTAGAGCGTGTTC.1	Mid
TTCAAAGTCTCTAGCC.1	Central
TTCAATACTCTGAATC.1	Central
TTCAGCCCTGGTCCAC.1	Central
TTCCAGACGAGATTTA.1	Portal
TTCCGCGTGAGGCGAT.1	Central
TTCCGGTATCTGTGTC.1	Periportal
TTCCGGTTACCCACTT.1	Mid
TTCCTCGGACTAACCA.1	Central
TTCGGGACTAATCGCG.1	Central
TTCTAACCGAAGCTTA.1	Central
TTCTGCCGCGCCTAGA.1	Mid
TTCTGCGGGTTAGCGG.1	Central
TTCTTATCCGCTGGGT.1	Mid
TTCTTGCTAGCATCTC.1	Mid
TTGAATATGGACTTTC.1	Central
TTGAATTCACGTGAGG.1	Mid
TTGACAGGAGCTCCCG.1	Periportal
TTGACTATTGTCCGGC.1	Mid
TTGAGAGTACTGCTAA.1	Periportal
TTGAGCGCCACGTGAT.1	Mid
TTGCCGCTTTCTAGTA.1	Periportal
TTGCTGATCATGTTCG.1	Central
TTGGGCGGCGGTTGCC.1	Mid
TTGGTATGGCTTGTGT.1	Central
TTGTTGTGTGTCAAGA.1	Mid